a,a,a,a,a,a,a,a,a,a,a,a,a,a,a,a,a,a,a,a,a,a,a,a,a,a,a,a,a,a,a,a,a,a,a,a,a,a,a,a,g,g,g,g,g,g,g,g,g,g,g,g,d,d,d,d,d,d,d,d,d,d,d,d,d,d,d,u,u,u,d,d,a,a,a,a,a,a,a,a,a,a,a,a,a,a,a,a,a,a,a,a,a,a,a,a,a,a,a,a
a,a,a,a,a,a,a,a,a,a,a,a,a,a,a,a,a,a,a,a,a,a,a,a,a,a,a,a,a,a,a,a,a,g,g,g,a,a,a,g,d,d,d,d,d,d,d,d,d,d,d,d,d,d,d,d,d,d,d,d,d,d,u,u,u,u,u,u,u,u,d,d,d,a,a,a,a,a,a,a,a,a,a,a,a,a,a,a,a,a,a,a,a,a,a,a,a,a,a,a
a,a,a,a,a,a,a,a,a,a,a,a,a,a,a,a,a,a,a,a,a,a,a,a,a,a,a,g,g,g,g,g,g,d,d,d,g,g,g,d,d,d,d,d,d,d,d,d,d,d,d,d,d,d,d,d,d,u,u,u,u,u,u,u,u,u,u,u,u,d,d,a,a,a,a,a,a,a,a,a,a,a,a,a,a,a,a,a,a,a,a,a,a,a,a,a,a,a,a,a
a,a,a,a,a,a,a,a,a,a,a,a,a,a,a,a,a,a,a,a,a,a,a,a,a,a,a,d,d,d,d,d,d,d,d,d,d,d,d,d,d,d,d,d,d,d,d,d,u,u,u,u,u,u,u,u,u,u,u,u,u,u,u,u,u,u,u,u,d,a,a,a,a,a,a,a,a,a,a,a,a,a,a,a,a,a,a,a,a,a,a,a,a,a,a,a,a,a,a,a
a,a,a,a,a,a,a,a,a,a,a,a,a,a,a,a,a,a,a,a,a,a,a,a,a,a,g,d,d,d,d,d,d,d,d,d,d,d,d,d,d,u,u,u,u,u,u,u,u,u,u,u,u,u,u,u,u,u,u,u,u,u,u,u,u,u,u,a,a,a,a,a,a,a,a,a,a,a,a,a,a,a,a,a,a,a,a,a,a,f,a,a,a,a,a,a,a,a,a,a
a,a,a,a,a,a,a,a,a,a,a,a,a,a,a,a,a,a,a,a,a,a,a,a,a,g,d,d,d,d,d,d,d,u,u,d,d,d,d,d,u,u,u,u,u,u,u,u,u,u,u,u,u,u,u,u,u,u,u,u,u,u,a,a,a,a,a,a,a,a,a,a,a,a,a,a,a,a,a,a,a,a,a,a,a,a,a,a,a,p,a,a,a,a,a,a,a,a,a,a
a,a,a,a,a,a,a,a,a,a,a,a,a,a,a,a,a,a,a,a,a,a,a,a,a,d,d,d,d,d,d,d,u,u,u,u,d,d,u,u,u,u,u,u,u,u,u,u,u,u,u,u,u,u,u,u,u,a,a,a,a,a,a,a,a,a,a,a,a,a,a,a,a,a,a,a,a,a,a,a,a,a,a,a,a,a,s,a,a,p,a,a,a,a,a,a,a,a,a,a
a,a,a,a,a,a,a,a,a,a,a,a,a,a,a,a,a,a,a,a,a,a,a,a,d,d,d,d,d,d,d,u,u,u,u,u,u,d,u,u,u,u,u,u,u,u,u,u,u,a,a,a,a,a,a,a,a,a,a,a,a,a,a,a,a,a,a,a,a,a,a,a,a,a,a,a,a,a,a,a,a,a,a,a,a,s,s,a,a,p,a,a,a,a,a,a,a,a,a,a
g,g,g,g,g,g,g,g,g,g,g,g,g,g,g,g,g,a,a,a,a,a,a,a,d,d,d,u,u,u,u,u,u,u,u,u,u,d,u,u,u,u,a,a,a,a,a,a,a,a,a,a,a,a,a,a,a,a,a,a,a,a,a,a,a,a,a,a,a,a,a,a,a,a,a,a,a,a,a,a,a,a,a,a,s,s,s,a,a,p,a,a,a,a,a,a,a,a,a,a
d,d,d,d,d,d,d,d,d,d,d,d,d,d,d,d,d,a,a,a,a,a,a,a,d,d,u,u,u,u,u,u,u,u,u,u,u,u,u,a,a,a,a,a,a,a,a,a,a,a,a,a,a,a,a,a,a,a,a,a,a,a,a,a,a,a,a,a,a,a,a,a,a,a,a,a,a,a,a,a,a,a,a,s,s,s,s,a,a,p,a,a,a,a,a,a,a,a,a,a
d,d,d,d,d,d,d,d,d,d,d,d,d,d,d,d,d,g,a,a,a,a,a,a,a,a,u,u,u,u,u,u,u,a,a,a,u,u,a,a,a,a,a,a,a,a,a,a,a,a,a,a,a,a,a,a,a,a,a,a,a,a,a,a,a,a,a,a,a,a,a,a,a,a,a,a,a,a,a,a,a,a,s,s,s,s,s,a,a,p,a,a,a,a,a,a,a,a,a,a
d,d,d,d,d,d,d,d,d,d,d,d,d,d,d,d,d,d,a,a,a,a,a,a,a,a,a,u,u,u,u,u,a,a,a,a,a,a,a,a,a,a,a,a,a,a,a,a,a,a,a,a,a,a,a,a,a,a,a,a,a,a,a,a,a,a,a,a,a,a,a,a,a,a,a,a,a,a,a,a,a,s,s,s,s,s,s,a,a,p,a,a,a,a,a,a,a,a,a,a
d,d,d,d,d,d,d,d,d,d,d,d,d,d,d,d,d,d,a,a,a,a,a,a,a,a,a,a,a,a,a,a,a,a,a,a,a,a,a,a,a,a,a,a,a,a,a,a,a,a,a,a,a,a,a,a,a,a,a,a,a,a,a,a,a,a,a,a,a,a,a,a,a,a,a,a,a,a,a,a,s,s,s,s,s,s,s,a,a,p,a,a,a,a,a,a,a,a,a,a
d,d,d,d,d,d,d,d,d,d,d,d,d,d,d,d,d,d,g,g,g,g,a,a,a,a,a,a,a,a,a,a,a,a,a,a,a,a,a,a,a,a,a,a,a,a,a,a,a,a,a,a,a,a,a,a,a,a,a,a,a,a,a,a,a,a,a,a,a,a,a,a,a,a,a,a,a,a,a,s,s,s,s,s,s,s,s,a,a,p,a,a,a,a,a,a,a,a,a,a
d,d,d,d,d,d,d,d,d,d,d,d,d,d,d,d,d,d,d,d,d,d,a,a,a,a,a,a,a,a,a,a,a,a,a,a,a,a,a,a,a,a,a,a,a,a,a,a,a,a,a,a,a,a,a,a,a,a,a,a,a,a,a,a,a,a,a,a,a,a,a,a,a,a,a,a,a,a,s,s,s,s,s,s,s,s,s,a,a,p,a,a,a,a,a,a,a,a,a,a
d,d,d,d,d,d,d,d,d,d,d,d,d,d,d,d,d,d,d,d,d,d,d,a,a,a,a,a,a,a,a,a,a,a,h,h,h,a,a,a,a,a,a,a,a,a,a,a,a,a,a,a,a,a,a,a,a,a,a,a,a,a,a,a,a,a,a,a,h,h,h,h,h,h,h,h,h,d,d,d,d,d,d,d,d,d,d,g,g,g,g,g,g,g,g,g,g,g,g,g
d,d,d,d,d,d,d,d,d,d,d,d,d,d,d,d,d,d,d,d,d,d,d,d,a,a,a,a,a,a,a,a,h,h,u,u,u,a,a,a,a,a,a,a,a,a,a,a,a,a,a,a,a,a,a,a,a,a,a,a,a,a,a,h,h,h,h,h,u,u,u,u,u,u,u,u,u,d,d,d,d,d,d,d,d,d,d,d,d,d,d,d,d,d,d,d,d,d,d,d
d,d,d,d,d,d,d,d,d,d,d,d,d,d,d,d,d,d,d,d,d,d,d,d,d,d,d,h,h,h,h,h,u,u,u,u,u,h,a,a,a,a,a,a,a,a,a,a,a,a,a,a,a,a,a,a,a,h,h,h,h,h,h,u,u,u,u,u,u,u,u,u,u,u,u,u,d,d,d,d,d,d,d,d,d,d,d,d,d,d,d,d,d,d,d,d,d,d,d,d
d,d,d,d,d,d,d,d,d,d,d,d,d,d,d,d,d,d,d,d,d,d,d,d,d,d,d,u,u,u,u,u,u,u,u,u,u,u,h,h,h,h,h,h,h,a,h,a,h,a,h,a,h,h,h,h,h,u,u,u,u,u,u,u,u,u,u,u,u,u,u,u,u,u,u,d,d,d,d,d,d,d,d,d,d,d,d,d,d,d,d,d,d,d,d,d,d,d,d,d
d,d,d,d,d,d,d,d,d,d,d,d,d,d,d,d,d,d,d,d,d,d,d,d,d,d,d,u,u,u,u,u,u,u,u,u,u,u,u,u,u,u,u,u,u,a,u,a,u,a,u,a,u,u,u,u,u,u,u,u,u,u,u,u,u,u,u,u,u,d,d,d,d,d,d,d,d,d,d,d,d,d,d,d,d,d,d,d,d,d,d,d,d,d,d,d,d,d,d,d
